1111111111
10000E1111
1111111111
1000000001
1P000C1111
1111111111
