111111111
1P0000P11
111110001
1C00000E1
111111111
