111111111111111111111111111
1000E0000000000000000000001
1000000000000C0000000000001
100000000000000000000000P01
10C000000001111111110000001
100000000001000000000000001
100000011001000000000000001
100000011001111100000001111
100C00000000000100000000C01
100000000000000100000000001
111111111111111111111111111
