111111111111111111
1000E00C000C000011
110001111001100011
100000C00C00001111
11000000000P011111
1110000C1110001111
111111111111111111
