111111
100001
110P01
11C001
111111
