111111
1000E1
1C00P1
111111
1
