1111111111
100000001
1E0000P11
1111C1111
111111111
