11111111111
100000E0001
100P00000111
11100000011
111100C0111
11111111111
