11111
10001
1P0C1
111E1
11111
